F F F F F F F F F F
F W W W G G G W W F
F G G G G G G G G G
G G G G G G G G G G
G G W G G W G G G G
G G G G G G G G G G
G G G G W W G G G G
G G G G G G G G G G