M M M M M M M M M M
M H H H G G G H H M
M G G G G G G G G G
G G G G G G G G G G
G G M G H H G M G G
G G G G G G G G G G
G G G G W W G G G G
G G G G G G G G G G